11111111111111111111111111
1000000E0000000C0000000001
100000000000C11P0000000001
10000000000C00000000000001
11111111111111111111111111