11111
10E01
10P01
100C1
111111212