11111111111111111111111111111111111111111111111111111111111111111111111111111111111111111111111111111111111111111111111111111111111111111111111
1000000000000000000000000000000000000000000000000000000000000000000000000000000000000000000000000000000000000000CCCCCC1111111111111111111111111
1000000000000000000000000000000000000000000000000000000000000000000000000000000000000000000000000000000000000000CCCCCC1111111111111111111111111
10000000000000000000000000000E0000000000000000000000000000000000000000000000000000000000000000000000000000000000CCCCCC1111111111111111111111111
10000000000000000000000000000000000000CCC00000000000000000000000000000000000000000000C00000000000000000000000000CCCCCC1111111111111111111111111
1000000000000000000000000000000000000000000000000000000000000000000000000000000000000000000000000000000000000000CCCCCC1111111111111111111111111
1000000000000000000000000000000000000000000000000000000000000CC0000000000000000000000000000000000000000000000000CCCCCC1111111111111111111111111
1000000CCCCC0000000000000000000000000000000000000000000000000000000000000000000000000000000000000000000000000000CCCCCC1111111111111111111111111
100000000000000000000000000000000000000000000000000000000000C000000000000000000000000000000000000000000000000000CCCCCC1111111111111111111111111
1000000000000000000000000000000000000000000000000000000000001000000000000000000000000000000000000000000000000000CCCCCC1111111111111111111111111
1000000000000000000000000000000000000000000000000000000000001000000000000000000000000000000000000000000000000000CCCCCC1111111111111111111111111
1000000000000000000000000000000000000000000000000000000000001000000000000000000000000000000000000000000000000000CCCCCC1111111111111111111111111
1000000000000000000000000000000000000000000000000000000000001000000000000000000000000000000000000000000000000000CCCCCC1111111111111111111111111
1000000000000000000000000000000000000000000000000000000000001000000000000000000000000000000000000000000000000000CCCCCC1111111111111111111111111
100000000000000000000000000000000000000000000000000000000C0010000000000000000000000000C00000000000000000000000000CCCCC1111111111111111111111111
10000000000000000000000000000000000000000000000000000000010000000000000000000000000000C0000000000000000000000000CCCCCC1111111111111111111111111
10000000000000000000000000000000000000000000000000000000110000000000000000000000000000C0000000000000000000000000CCCCCC1111111111111111111111111
10000000000000000000000000000000000000000000000000000001000000000C00000000000000000000C0000000000000000000000000CCCCCC1111111111111111111111111
1000000000000000000000000000000000000000000000000000001000000000000000000000000000000010000000000000000000000000CCCCCC1111111111111111111111111
10000000000000000000000000000000000000000000000000000010000C00000000000000000000000000C0000000000000000000000000CCCCCC1111111111111111111111111
10000000000000000000000000000000000000000000000000000000000C00000000000000000000000000C0000000000000000000000000CCCCCC1111111111111111111111111
1000000000000000000000000000000000000000000000000000000000000000000000000000000000000000000000000000000000000000CCCCCC1111111111111111111111111
10000000000000000000000000000000000000000000000000000000000000000C0000000000C00000000C00000000000000000000000000CCCCCC1111111111111111111111111
10000000000000000000000000000000000000000000000000000000000P0000000000000000000000000000000000000000000000000000CCCCCC1111111111111111111111111
1000000000000000000000000000000000000000000000000000000000000000000000000000000000000000000000000000000000000000CCCCCC1111111111111111111111111
1000000000000000000000000000000000000000000000000000000000000000000000000000000000000000000000000000000000000000CCCCCC1111111111111111111111111
11111111111111111111111111111111111111111111111111111111111111111111111111111111111111111111111111111111111111111111111111111111111111111111111