11111111111111111111111111
1000001E1000000C0000000001
100000010000C10P0000000001
10000000000C00010000000001
11111111111111111111111111
